0000000000000000000000000000000000000000000000000000000000000000000000000000000000000000000000000000
0111111111111111111111111111111111111111011111111111111111111111111111111111111111111111111111111110
0111111111111111111111111111111111111111011111111111111111111111111110001111111111111111111111111110
0111111111111111111111111111111111111111011111111111110111111111111100000111111111111111111111111110
0111111111111110001111111111111111111111011111111111111111111111111100000111111111111111111111111110
0111111111111110001111111111111111111111011111111111111111111111111110001111111111111111111111111110
0111111111111110001111111111111111111111111111111111011111111111111111111111111111111111111111111110
0111111111111111111111111111111111111111111111111111111111111111111111111111111111111110001111111110
0111111111111111111111111111111111111111111111111111111111111111111111111111111111111111111111111110
0111111111111000000000000000000000000000000000000111111000000000000000000000000111110000000000000000
0111111111111000000000000000000000000000000000000111111000000000000000000000000111110000000000000000
0111111111111111111111111111111111111111011111111111111111111111111111111111111111111111111111111110
0111111111111111111111111111111111111111011111111111111111111111111110001111111111111111100011111110
0111111111111111111111111111111111111111011111111111110111111111111100000111111111111111100011111110
0111111111111110001111111111111111111111011111111111111111111111111100000111111111111111100011111110
0111111111111111111111111111111111111111011111111111111111111111111110001111111111111111111111100110
0111111111111110001111111111111111111111111111111111011111111111111111111111111111111111111111111110
0111111111111111111111111111111111111111111111111111111111111111111111111111111111111110001111111110
0111111111111111111111111111111111111111111111111111111111111111111111111111111111111111111111111110
0000000011111100000000000000000000000000000001111111111111111100000000000000000000000000000000000000
0000000011111100000000000000000000000000000001111111111111111100000000000000000000000000000000000000
0111111111111111111111111111111111111111011111111111111111111111111111111111111111111111111111111110
0111111111111111111111111111111111111111011111111111111111111111111110001111111111111111111111111110
0111111111111111111111111111111111111111011111111111110111111111111110001111111111111111111111000000
0000011111111110001111111111001111111111011111111111110111111111111110001111111111111111111111000000
0000011111111110001111111111001111111111011111111111110111111111111110001111111111111111111111111110
0000011111111110001111111111001111111111111111111111000111111111111111111111111111111110000000000000
0111111111111111111111111111001111111111111111111111111111111111111111111111111111111110000000000000
0111111111111111111111111111001111111111111111111111111111111111111111111111111111111111111111111110
0000000000000000001111111111000000000000000111111111000000000000000001111111111110000000000000000110
0000000000000000001111111111000000000000000111111111000000000000000001111111111110000000000000000110
0111111111111111111111111111111111111111011111111111111111111111111111111111111111111111111111111110
0111111111111111111111111111111111111111011111111111111111111111111111111111111111111111110000001110
0111111110000000111111111111111111111111011111111111110111111111111111000000000001111111110011001110
0111111110000111111111111111111111111111011111111111110111111111111111000000000001111111111111111110
0111111110000111111111111111111111111111011111111111110111111111111111111111111111111111111111111110
0111111110000111111111111111111111111111111111111111000111111111111111111111111111111111111111111110
0111111110000000111111111111111111111111111111111111111111111111111111111110000001111110001111111110
0111111111111111111111111111111111111111111111111111111111111111111111111111111111111111111111111110
0111100000000000000000000000000000001111000000000111100000000000000000000001111111111110000000000110
0111100000000000000000000000000000001111000000000111100000000000000000000001111111111110000000000110
0111111111111111111111111111111111111111011111111111111111111111111111111111111111111111111111111110
0111111111111111111111111111111111111111011111111111111111111111111110001111111111111111111111111110
0111111111111111111111111111111111111111011111111111110111111111111100000111111111111111111111111110
0111111111111110001111111111111111111111011111111111111111111111111100000111111111111111111111111110
0111111111111110001111111111111111111111011111111111111111111111111110001111111111111111111111111110
0111111111111110001111111111111111111111111111111111011111111111111111111111111111111111111111111110
0111111111111111111111111111111111111111111111111111111111111111111111111111111111111110001111111110
0111111111111111111111111111111111111111111111111111111111111111111111111111111111111111111111111110
0111111111111111111111111111100000000000000000000000000000000000000000000000000000000000000000000000
0111111111111111111111111111100000000000000000000000000000000000000000000000000000000000000000000000
0111111111111111111111111111111111111111011111111111111111111111111111111111111111111111111111111110
0111111111111111111111111111111111111111011111111111111111111111111110001111111111111111111111111110
0111111111111111111111111111111111111111011111111111000111111111111100000111111111111111111111111110
0111111111111110001111111111111111111111011111111111000111111111111100000111111111111111111111111110
0111111111111110001111111111111111111111011111111111000111111111111110001111111111111111111111111110
0111111111111110001111111111111111111111111111111111000111111111111111111111111111111111111111111110
0111111111111111111111111111111111111111111111111111111111111111111111111111111111111110001111111110
0111111111111111111111111111111111111111111111111111111111111111111111111111111111111111111111111110
0000000000001111110000000000000000000000001111111100000000000000000000000000000000001111111111111110
0000000000001111110000000000000000000000001111111100000000000000000000000000000000001111111111111110
0111111111111111111111111111111111111111001111111111111111111111111111111111111111111111111111111110
0111111111111111111111111111111111111111001111111111111111111111111100001111111111111111111111111110
0111111111111111111111111111111111111111001111111111111111111111111100001111111111111111111111111110
0111111111111110001111111111111111111111001111111111111111111111111100001111111111111111111111111110
0111111111111110001111111111111111111111001111111111111111111111111100001111111111111110001111111110
0111111111111110001111111111111111111111111111111111111111111111111111111111111111111110001111111110
0111111111111111111111111111111111111111111111111111111111111111111111111111111111111110001111111110
0111111111111111111111111111111111111111111111111111111111111111111111111111111111111111111111111110
0111111111111111111111111111111111111111001111111111111111111111111111111111111111111111111111111110
0111111111111111111111111111111111111111001111111111111111111111111111111111111111111111111111111110
0111111111111111111111111111111111111111001111111111111111111111111111111111111111111111111111111110
0111111111111111111111111111111111111111001111111111111111111111111100000111111111111111111111111110
0111111111111111111111111111111111111111001111111111111111111111111100000111111111111111111111111110
0111111111111110001111111111111111111111001111111111111111111111111100000111111111111110001111111110
0000000001111110001111111111111111111111001111111110000111111111111100000111111111111110001111111110
0000000001111110001111111111111111111111111111111110000111111111111100000111111111111110001111111110
0111111111111111111111111111111111111111111111111110000111111111111100000111111111111110001111111110
0111111111111111111111111111111111111111111111111110000111111111111111111111111111111111111111111110
0111111000000001110000000111111111000000000000000000000000000000000000000000000111111110000000000000
0111111000000001110000000111111111000000000000000000000000000000000000000000000111111110000000000000
0111111111111111111111111111111111111111011111111111111111111111111111111111111111111111111111111110
0111111111111111111111111111111111111111011111111111111111111111111111111111111111111111111111111110
0111111111111111111111111111111111111111011111111111100111111111111110001111111111111111111111111110
0000000111111110001111111111111111111111011111111111100111111111111110001111111111111110001111111110
0000000111111110001111111111111111111111011111111111100111111111111110001111111111111110001111111110
0000000111111110001111111111111111111111111111111111100111111111111110001111111111111110001111111110
0111111111111111111111111111111111111111111111111111111111111111111110001111111111111110001111111110
0111111111111111111111111111111111111111111111111111111111111111111111111111111111111111111111111110
0000000000000000001111111111000000000000000111111111000000000000000000000000000000000000000000000000
0000000000000000001111111111000000000000000111111111000000000000000001111111111110000000000000000110
0111111111111111111111111111111111111111011111111111111111111111111111111111111111111111111111111110
0111111111111111111111111111111111111111011111111111111111111111111111111111111111111111110000001110
0111111110000000111111111111111111111111011111111111110111111111111111000000000001111111110011001110
0111111110000111111111111111111111111111011111111111110111111111111111000000000001111111111111111110
0111111110000111111111111111111111111111011111111111110111111111111111111111111111111111111111111110
0111111110000111111111111111111111111111111111111111000111111111111111111111111111111111111111111110
0111111110000000111111111111111111111111111111111111111111111111111111111110000001111110001111111110
0111111111111111111111111111111111111111111111111111111111111111111111111111111111111111111111111110
0000000000000000000000000000000000000000000000000000000000000000000000000000000000000000000000000000
